[ ['+','+','+','+',...,'+','+','+','+','+','+','+'],
['+',' ',' ',' ',...,' ',' ',' ','+',' ',' ',' '],
['+',' ','+',' ',...,'+','+',' ','+',' ','+','+'],
['+',' ','+',' ',...,' ',' ',' ','+',' ','+','+'],
['+','+','+',' ',...,'+','+',' ','+',' ',' ','+'],
['+',' ',' ',' ',...,'+','+',' ',' ',' ',' ','+'],
['+','+','+','+',...,'+','+','+','+','+',' ','+'],
['+',' ',' ',' ',...,'+','+',' ',' ','+',' ','+'],
['+',' ','+','+',...,' ',' ','+',' ','Q',' ','+'],
['+',' ',' ',' ',...,' ',' ','+',' ','+','+','+'],
['+','+','+','+',...,'+','+','+',' ','+','+','+']]